1111111111
111C0000P1
1111110111
1111110001
1111111101
1111111101
1111111101
1111111101
11E0000001
1111111111
