1111111111111111111111
1C00001C1C101000C01E11
1000001000101010101011
1000001110101010001011
1000C01010101001101011
1000001010100100101011
1000001110100010101011
1000001010100100101011
100C001010101001001011
1000000010101001010011
10000000000C000000P111
1111111111111111111111
